#################
#O.............O#
#.#.####.####.#.#
#.#...........#.#
#.#.#.#####.#.#.#
#.#.#.......#.#.#
#...#.#...#.#...#
#.#.#.#...#.#.#.#
#.#...........#.#
#.#.#########.#.#
#O.............O#
#################
