######################
#O...#..........#...O#
#.##.#.########.#.##.#
#.#................#.#
#.#.##.###  ### ##.#.#
#.#....#      #....#.#
#...##.########.##...#
#.#................#.#
#.#.##.########.##.#.#
#.#................#.#
#.##.#.########.#.##.#
#O...#..........#...O#
######################
