#####################
#   ......O......   #
# # ############# # #
#  ...............  #
#.#.###.#####.###.#.#
#.#.#.....#.....#.#.#
#.#.#.###.#.###.#.#.#
#.#...#.......#...#.#
#.#.#.#.## ##.#.#.#.#
#.#.#...#   #...#.#.#
#O#.###.     .###.#O#
#.#.#...#   #...#.#.#
#.#.#.#.## ##.#.#.#.#
#.#...#.......#...#.#
#.#.#.###.#.###.#.#.#
#.#.#.....#.....#.#.#
#.#.###.#####.###.#.#
#  ...............  #
# # ############# # #
#   ......O......   #
#####################
